#########################################################
#@.....$###########+......##+$...ggggggggggggggggggggggg#
#######.###########.##g##.########.##.$$.##g##g##g$$g++g#
#######.###########.##.##.##$#####.##.$$.##g##g##g$$g++g#
####...$###########.##...$##$##....gggggggggggg..ggggggg#
####$##############.##.#####g#####.##.##.##.##.#g.##.##g#
####.##############.##.#####.#####.##.#g.##.##.##.##.##g#
#gggg##############.##..........$...g..........ggggggggg#
#g#################.########.##.##....##.#..#..##.##.##.#
#g#####g###########.########.##.##..#g##ggggg#.##.##.##.#
#..$$$.......gggg...##ggg+##........gggg$gggg..........##
####g##.###########.##..gg##.##.##$##gg$+$gg##.##.#ggg#$#
####g##.###########.##$$$$##.##$##.##ggg$ggg##.##.##.#>##
#+gggggg###########.......##..........ggggg.........#+###
#########################################################
