######################################################
##################################################gg>#
#####.......###...##......########$$$++###########ggg#
####...##.#...@....#..##..........$$$$$##########..###
####.##...###....#....##..########$$$$g##########.####
####.##.#########################################.####
####.....#####################################....####
####....######################################.#######
###.....######################################.#######
###......##################GGGGGGGG###########.#######
#####$$$...#############GGG........GGG########.#######
####ggg$$#############GG....$$$$$$....G######..#######
#####ggggg#.................$$++$$....G.....#.########
######gggggg##########GG....$$$$$$...GG####.#.#$++####
######ggggg#############GGG.......GGG######.#.#ggg####
####ggggggg################GGGGGGG#########...###.####
######ggggggg####################################.####
#####ggggggg#####################################.####
#####.ggggg######################################.####
######ggggg##########$$$.$$$#####################.####
####gggggg..........#$$$.$$$#.....................####
#####gggggg########.#$$$.$$$#.#######ggggggggg########
#######ggg#########.####.####.#######gGggGggGg########
###################...........#######ggggggggg########
######################################################
